{
  "level": 10,
  "description": "Everything togheter mixed pickups",
  "templates": [
    [
      [ 0, 0, 6, 6, 0, 0 ],
      [ 0, 0, 1, 1, 0, 0 ],
      [ 0, 0, 0, 0, 0, 0 ],
      [ 0, 1, 0, 0, 1, 0 ],
      [ 0, 2, 0, 0, 2, 0 ]
    ],
    [
      [ 0, 0, 0, 0, 0, 0 ],
      [ 0, 0, 6, 0, 6, 0 ],
      [ 0, 0, 0, 0, 0, 0 ],
      [ 1, 0, 1, 0, 1, 0 ],
      [ 0, 2, 0, 0, 2, 0 ]
    ],
    [
      [ 0, 0, 0, 0, 0, 0 ],
      [ 0, 0, 0, 0, 0, 0 ],
      [ 0, 0, 0, 0, 0, 0 ],
      [ 1, 0, 1, 0, 1, 0 ],
      [ 0, 2, 0, 6, 2, 6 ]
    ],
    [
      [ 0, 0, 0, 0, 6, 0 ],
      [ 0, 0, 1, 0, 0, 0 ],
      [ 0, 1, 0, 0, 0, 0 ],
      [ 1, 0, 0, 0, 0, 0 ],
      [ 0, 2, 0, 0, 2, 0 ]
    ],
    [
      [ 0, 0, 0, 0, 0, 0 ],
      [ 0, 0, 0, 0, 0, 0 ],
      [ 0, 0, 0, 0, 0, 0 ],
      [ 0, 6, 0, 0, 0, 0 ],
      [ 6, 2, 6, 6, 2, 6 ]
    ],
    [
      [ 0, 0, 0, 0, 0, 0 ],
      [ 0, 0, 0, 0, 0, 0 ],
      [ 0, 0, 0, 0, 0, 0 ],
      [ 0, 6, 0, 0, 6, 0 ],
      [ 0, 2, 6, 6, 2, 0 ]
    ]
  ]
}
