{
  "level": 5,
  "description": "platforms mixed pickups",
  "templates": [
    [
      [ 0, 0, 0, 0, 0, 0 ],
      [ 0, 0, 0, 0, 0, 0 ],
      [ 6, 0, 0, 0, 0, 6 ],
      [ 1, 1, 0, 0, 1, 1 ],
      [ 0, 0, 6, 0, 0, 0 ]
    ],
    [
      [ 0, 0, 0, 0, 0, 0 ],
      [ 0, 0, 0, 6, 6, 0 ],
      [ 0, 0, 0, 1, 1, 0 ],
      [ 0, 1, 1, 0, 0, 0 ],
      [ 0, 0, 0, 0, 0, 0 ]
    ],
    [
      [ 0, 0, 0, 0, 0, 0 ],
      [ 0, 0, 0, 0, 6, 0 ],
      [ 0, 0, 0, 6, 0, 0 ],
      [ 0, 0, 1, 1, 0, 0 ],
      [ 0, 0, 0, 0, 0, 0 ]
    ],
    [
      [ 0, 0, 0, 0, 0, 0 ],
      [ 0, 0, 0, 0, 0, 0 ],
      [ 0, 0, 6, 0, 6, 0 ],
      [ 0, 1, 0, 1, 0, 0 ],
      [ 0, 0, 0, 0, 0, 0 ]
    ],
    [
      [ 0, 0, 0, 0, 0, 0 ],
      [ 0, 0, 0, 0, 0, 0 ],
      [ 0, 0, 6, 1, 1, 0 ],
      [ 0, 1, 1, 0, 6, 0 ],
      [ 0, 0, 0, 0, 0, 0 ]
    ]
  ]
}
