{
  "level": 5,
  "description": "platforms mixed pickups",
  "templates": [
    [
      [ 0, 0, 0, 0, 0 ],
      [ 0, 0, 0, 0, 0 ],
      [ 0, 5, 3, 0, 4 ],
      [ 1, 1, 1, 1, 1 ],
      [ 0, 0, 0, 0, 0 ]
    ],
    [
      [ 0, 0, 0, 0, 0 ],
      [ 0, 0, 0, 0, 0 ],
      [ 0, 0, 4, 5, 0 ],
      [ 1, 1, 1, 1, 1 ],
      [ 0, 0, 0, 0, 0 ]
    ],
    [
      [ 0, 0, 0, 0, 0 ],
      [ 0, 0, 0, 0, 0 ],
      [ 3, 0, 4, 0, 5 ],
      [ 1, 1, 1, 1, 1 ],
      [ 0, 0, 0, 0, 0 ]
    ]
  ]
}
