{
  "level": 3,
  "description": "pickups mixed / jumps",
  "templates": [
    [
      [ 0, 0, 0, 0, 0 ],
      [ 0, 0, 0, 0, 0 ],
      [ 0, 0, 0, 0, 0 ],
      [ 0, 0, 4, 0, 0 ],
      [ 0, 3, 0, 5, 0 ]
    ],
    [
      [ 0, 0, 0, 0, 0 ],
      [ 0, 0, 0, 0, 0 ],
      [ 0, 0, 0, 0, 0 ],
      [ 0, 0, 4, 0, 0 ],
      [ 0, 5, 0, 3, 0 ]
    ],
    [
      [ 0, 0, 0, 0, 0 ],
      [ 0, 0, 0, 0, 0 ],
      [ 0, 0, 0, 0, 0 ],
      [ 0, 0, 5, 0, 0 ],
      [ 0, 3, 0, 4, 0 ]
    ]
  ]
}
