{
  "level": 7,
  "description": "multiple platforms",
  "templates": [
    [
      [ 0, 0, 0, 0, 0, 0 ],
      [ 0, 0, 0, 0, 0, 0 ],
      [ 0, 0, 0, 0, 0, 0 ],
      [ 0, 0, 0, 0, 0, 0 ],
      [ 0, 6, 6, 0, 2, 0 ]
    ],
    [
      [ 0, 0, 0, 0, 0, 0 ],
      [ 0, 0, 0, 0, 0, 0 ],
      [ 0, 0, 0, 0, 0, 0 ],
      [ 0, 6, 0, 0, 0, 0 ],
      [ 0, 2, 6, 0, 0, 0 ]
    ],
    [
      [ 0, 0, 0, 0, 0, 0 ],
      [ 0, 0, 0, 0, 0, 0 ],
      [ 0, 0, 0, 0, 0, 0 ],
      [ 0, 6, 0, 0, 6, 0 ],
      [ 0, 2, 0, 0, 2, 0 ]
    ],
    [
      [ 0, 0, 0, 0, 0, 0 ],
      [ 0, 0, 0, 0, 0, 0 ],
      [ 0, 0, 0, 0, 0, 0 ],
      [ 0, 0, 0, 0, 6, 0 ],
      [ 0, 6, 0, 2, 0, 0 ]
    ],
    [
      [ 0, 0, 0, 0, 0, 0 ],
      [ 0, 0, 0, 0, 0, 0 ],
      [ 0, 0, 0, 0, 0, 0 ],
      [ 0, 6, 0, 6, 0, 0 ],
      [ 0, 0, 2, 0, 0, 6 ]
    ]
  ]
}
